0 0 1 1 2 3 5
0 1 2 1 1 3 2
1 2 1 0 3 3 2
1 1 0 3 3 1 2
1 1 3 3 0 1 2
1 2 3 1 1 1 2 
4 2 2 2 1 1 1